标注	说明
CNV Original	各样本区域覆盖的所有target的相关信息
CNV Filter	各样本区域覆盖的所有target经过过滤、合并获得的区域的相关信息
target过滤条件	天昊300样本CNV数据库注释的拷贝数增加的频率和拷贝数缺失的频率均小于等于0.1
target合并方式	在target文件中为连续区域，且所有样本分别在该连续区域的CNV类型一致
Start	片段起始
End	片段终止
Size	片段长度
Target_Num	区域覆盖的target数目
Gene	片段所在基因
Gene Region	片段所在基因的区域
Exon Cover	该区域覆盖的基因:转录本:外显子
Gain_Freq	所有样本中拷贝数增加的频率
Loss_Freq	所有样本中拷贝数缺失的频率
Gain_Sample	拷贝数增加的样本
Loss_Sample	拷贝数缺失的样本
CNV_DB_Gain_Freq	天昊300样本CNV数据库拷贝数增加的频率
CNV_DB_Loss_Freq	天昊300样本CNV数据库拷贝数缺失的频率
cytoBand	染色体条带区间
dgvFreq	DGV数据库中片段拷贝数的频率
iscaPathGainCum	ISCA（International Standards for Cytogenomic Arrays )数据库中拷贝数增加的样本数量
iscaPathLossCum	ISCA数据库中拷贝数减少的样本数量
iscaLikelyPathogenic	ISCA数据库中可能导致疾病
iscaPathogenic	ISCA数据库中导致疾病
iscaCuratedPathogenic	ISCA数据库中确认能导致疾病
CNVD	Copy Number Variation in Disease数据库注释，给出突变类型，相关基因以及对应的疾病
DECIPHER	DECIPHER数据库注释，给出缺失与多拷贝样本的频率以及样本总量
log2	相对拷贝数log2值
Posterior Probability	FastCall算法计算的后验概率
