Name	说明
Chr	染色体
Start	片段起始
End	片段终止
Length	片段长度
%gc	片段GC含量
Gene	片段所在基因
Gene Region	片段所在基因的区域
Gene Exon	片段在基因的第N个外显子
cytoBand	染色体条带区间
dgvFreq	DGV数据库中片段拷贝数的频率
iscaPathGainCum	ISCA（International Standards for Cytogenomic Arrays )数据库中拷贝数增加的样本数量
iscaPathLossCum	ISCA数据库中拷贝数减少的样本数量
iscaLikelyPathogenic	ISCA数据库中可能导致疾病
iscaPathogenic	ISCA数据库中导致疾病
iscaCuratedPathogenic	ISCA数据库中确认能导致疾病
CNVD	Copy Number Variation in Disease数据库注释，给出突变类型，相关基因以及对应的疾病
DECIPHER	DECIPHER数据库注释，给出缺失与多拷贝样本的频率以及样本总量
样本-CNV	样本的相对拷贝数(如果对照样本的归一化深度低于0.3，则设为ControlError)
样本/样本-Control	样本的归一化覆盖深度